2222000000222222200002222222222222222222222222222222
1111000000111111100001222222222222222222222222222222
0000000000000009004400111112222222222222222222222222
0000440000000000000000000001222222222222222222222222
0000000440000300050000000000111122222222222222222222
0000000000000000000000000000000021111111111111111112
0000000000000000000000000000000010000900000900000001
0000000000000000000000000000000000000000000000000000
0000000000000000000000000000000000000000000000000000
0000000000000000000000000000000000000000000000000000
0000000000000000000000000000000000000000000000000000
0000000000000000000000000000000000000000000000000000
