222200222222200000000200002222222222222222222222
111100111111100000000200002222222222222222222222
000000000090004400440100001109000900002222222222
000000000000000000000004004000000000002222222222
000000000034000000000000400044040400401111111111
000000000000000000000000000000000000000000000000
000444440000000000000000000000000000000000000000
000409040000000000000000000000000000000000000000
