222200222222200000000200002222222222222222222222222200222222222222202200002222222222222222222222
111100111111100000000200002222222222222222222222222202222222200000000200002222222222222222222222
000000000090004400440100001109000900002222222222000000000000000000000000000000000000000000000000
000000000000000040000004004000000000002222222222000009000000000000000000000000000000000000000000
000000000034000000400000400044040400401111111111000409040000000000000000000000000000000000000000
000000000000044000000000000000000000000000000000000409040000000000000000000000000000000000000000
000444440000055000000000000000000000000000000000000409040000000000000000000000000000000000000000
000409040000000000000000000000000000000000000000000409040000000000000000000000000000000000000000
