222200222222200000000200002222222222222222222222222200222222222222202200002222222222222222222222222222222
111100111111100000000200002222222222222222222222222202222222200000000200002111111112111111111111222222222
000000000090004400440100001109000900002222222222000000000000000000000040401000009001000000090000222222222
000000000000000040000004004000000000002222222222000000000000000000000000000000000000000000000000222222222
000000000034000000400000400044040455401111111111000400040000000000000000000000000000000000000000222222222
000000000000044000000000000000000000000000000000000400040000000000000000000000000000000000000000222222222
000444440000055000000000000000000000000000000000000400040000000000000000000000000000000000000000222222222
000409040000000000000000000000000000000000000000000400040000000000000000000000000000000000000000222222222
