222200222222200002222222222222222222222222222222
111100111111100001222222222222222222222222222222
000000000900004400111112222222222222222222222222
000000000000000000000001222222222222222222222222
000000003000050000000000111122222222222222222222
000000000000000000000000000011111111111111111111
000000000000000000000000000001000900000900010000
000000000000000000000000000040000000000000000000
000000000000000000000000040000040000000000003000
000000000000000000000000000040004000000000000000
000000000000000000000000000004000000000000000000
000000000000000000000000000030000000000000000000
