222221122222211112222222222222222222222222222222
111110011111100001222222222222222222222222222222
000000000000000000111112222222222222222222222222
000000000000000000000001222222222222222222222222
000000033300000000000000111122222222222222222222
000000000000000000000000000011111111111111111111
000000000000000000000000000000000000000000000000
000000000000000000000000000000000000000000000000
000000000000000000000000000000030000000000003000
